sgMYC-1	TGTACGCATCcgaggctgagtgtag
sgMYC-2	CGAGTAACTGcgaggctgagtgtag
sgMYC-3	ATGATCGCGAcgaggctgagtgtag
sgNRF1-1	CTTCGCCTTAcgaggctgagtgtag
sgNRF1-2	TCCTAGTACGcgaggctgagtgtag
sgNRF1-3	ATTTCTGCCTcgaggctgagtgtag
sgTHAP1-1	CGGCTCAGGAcgaggctgagtgtag
sgTHAP1-2	CACATGCCTAcgaggctgagtgtag
sgTHAP1-3	GAGTAGAGAGcgaggctgagtgtag
sgCEBPZ-1	AGCCTCTCTGcgaggctgagtgtag
sgCEBPZ-2	AAAGCGTAGCcgaggctgagtgtag
sgCEBPZ-3	TTCAGCCTCGcgaggctgagtgtag
sgHINFP-1	GGTGCCTCTTcgaggctgagtgtag
sgHINFP-2	CCTCCTCTACcgaggctgagtgtag
sgHINFP-3	TGCAGATCCAcgaggctgagtgtag
sgGTF2B-1	GTACAAACGGcgaggctgagtgtag
sgGTF2B-2	TAACCCAGCAcgaggctgagtgtag
sgGTF2B-3	GCCCCAACCTcgaggctgagtgtag
sgCTCF-1	CTCACCACACcgaggctgagtgtag
sgCTCF-2	TCGAAACCCAcgaggctgagtgtag
sgCTCF-3	ATTGTGACCAcgaggctgagtgtag
sgCDC5L-1	CGAGGGTCAAcgaggctgagtgtag
sgCDC5L-2	ACTGTCCGCGcgaggctgagtgtag
sgCDC5L-3	CAATATGGAAcgaggctgagtgtag
sgZBTB11-1	GAAACGAATTcgaggctgagtgtag
sgZBTB11-2	AGTCGACGCCcgaggctgagtgtag
sgZBTB11-3	AACACTTTGTcgaggctgagtgtag
sgBRF2-1	TTTTCAAGTAcgaggctgagtgtag
sgBRF2-2	GGGCTATCACcgaggctgagtgtag
sgBRF2-3	CCAATCTACTcgaggctgagtgtag
sgSETDB1-1	TGCCGGCAATcgaggctgagtgtag
sgSETDB1-2	GTCTTAGCAAcgaggctgagtgtag
sgSETDB1-3	TATAACTTATcgaggctgagtgtag
sgGATA1-1	ATGCTCGTTGcgaggctgagtgtag
sgGATA1-2	CGCAGTGAGTcgaggctgagtgtag
sgGATA1-3	CATGCACAGAcgaggctgagtgtag
sgNFYB-1	GCCGAGTGATcgaggctgagtgtag
sgNFYB-2	CTCTGTTAACcgaggctgagtgtag
sgNFYB-3	TCCTACCATTcgaggctgagtgtag
sgMAX-1	ATACGTGCTCcgaggctgagtgtag
sgMAX-2	ACAATTCTTGcgaggctgagtgtag
sgMAX-3	CAGGCATTTCcgaggctgagtgtag
sgGABPA-1	GAATGGCGTTcgaggctgagtgtag
sgGABPA-2	AGCTGCGAGGcgaggctgagtgtag
sgGABPA-3	AAGAGGTGTAcgaggctgagtgtag
sgZNF280A-1	TTAAATGACCcgaggctgagtgtag
sgZNF280A-2	GGTAAGATTGcgaggctgagtgtag
sgZNF280A-3	CCAAGGCACAcgaggctgagtgtag
sgRUNX1-1	CAGGACCTGAcgaggctgagtgtag
sgRUNX1-2	CTTACATTGCcgaggctgagtgtag
sgRUNX1-3	TAAGCTGACTcgaggctgagtgtag
sgKLF16-1	TGTAATAAGAcgaggctgagtgtag
sgKLF16-2	GTACTAAGTCcgaggctgagtgtag
sgKLF16-3	TAGCTGGTCTcgaggctgagtgtag
sgARID2-1	GCCTGTATTTcgaggctgagtgtag
sgARID2-2	CTTTTCATAAcgaggctgagtgtag
sgARID2-3	TCGACCCAAGcgaggctgagtgtag
sgTBP-1	ATTTATTTGGcgaggctgagtgtag
sgTBP-2	CGTTTAACGCcgaggctgagtgtag
sgTBP-3	ACACAGGATGcgaggctgagtgtag
sgKLF1-1	CTAGAGACTCcgaggctgagtgtag
sgKLF1-2	CAGCCGATGCcgaggctgagtgtag
sgKLF1-3	CGACAATACGcgaggctgagtgtag
sgZZZ3-1	AAGGGAACCGcgaggctgagtgtag
sgZZZ3-2	TTTAGCCGGTcgaggctgagtgtag
sgZZZ3-3	GGCCCATGAGcgaggctgagtgtag
sgZNF407-1	TGGACCGTTTcgaggctgagtgtag
sgZNF407-2	GTTTTGGATCcgaggctgagtgtag
sgZNF407-3	TAATCATCATcgaggctgagtgtag
sgTFDP1-1	GCCGTGTTGGcgaggctgagtgtag
sgTFDP1-2	CTTGTTGTTAcgaggctgagtgtag
sgTFDP1-3	TCGGTTTACCcgaggctgagtgtag
sgYY1-1	CGGTTCCCATcgaggctgagtgtag
sgYY1-2	ACATTGGCCGcgaggctgagtgtag
sgYY1-3	CATCATTCCCcgaggctgagtgtag
sgARID3A-1	GACCGAATACcgaggctgagtgtag
sgARID3A-2	AGATAGCTGAcgaggctgagtgtag
sgARID3A-3	CAGATCATTCcgaggctgagtgtag
sgPBX2-1	TTGCAACTGTcgaggctgagtgtag
sgPBX2-2	GGATCTCGGGcgaggctgagtgtag
sgPBX2-3	CCAGACATTAcgaggctgagtgtag
sgATF1-1	TCCTCTCTATcgaggctgagtgtag
sgATF1-2	ATTATCCTCTcgaggctgagtgtag
sgATF1-3	CGAGAGTAGAcgaggctgagtgtag
sgATF3-1	ACGTAAGGAGcgaggctgagtgtag
sgATF3-2	CAACTGCATAcgaggctgagtgtag
sgATF3-3	GAAAGGAGTAcgaggctgagtgtag
sgELF1-1	AGCTAAGCCTcgaggctgagtgtag
sgELF1-2	AATGGAAATCcgaggctgagtgtag
sgELF1-3	TTAACATGATcgaggctgagtgtag
sgNFE2-1	GGTGATGAAAcgaggctgagtgtag
sgNFE2-2	CCGTCGGACTcgaggctgagtgtag
sgNFE2-3	TGTTTCTAGCcgaggctgagtgtag
sgREST-1	GTTAACCAAGcgaggctgagtgtag
sgREST-2	TAGTGTATCGcgaggctgagtgtag
sgREST-3	GCTCCATCAAcgaggctgagtgtag
sgTRIM28-1	CGCAGCAACGcgaggctgagtgtag
sgTRIM28-2	ACGGTTCAATcgaggctgagtgtag
sgTRIM28-3	CAACATTCGTcgaggctgagtgtag
sgFOSL1-1	GAGATTCCCAcgaggctgagtgtag
sgFOSL1-2	AGCGGACTGCcgaggctgagtgtag
sgFOSL1-3	AAAGCCGTTCcgaggctgagtgtag
sgCEBPB-1	TTATTGGGTCcgaggctgagtgtag
sgCEBPB-2	GGTGCATACTcgaggctgagtgtag
sgCEBPB-3	CCGGGCTTGGcgaggctgagtgtag
sgBCLAF1-1	TGGACGTGGCcgaggctgagtgtag
sgBCLAF1-2	GTGCAAATTTcgaggctgagtgtag
sgBCLAF1-3	TAGCAGCCTCcgaggctgagtgtag
sgCUX1-1	GCTCCGAGTTcgaggctgagtgtag
sgCUX1-2	CTGCATTAAGcgaggctgagtgtag
sgCUX1-3	TCACGATAACcgaggctgagtgtag
sgNT-1	GGCACTTCTAcgaggctgagtgtag
sgNT-2	ATACTGATTCcgaggctgagtgtag
sgNT-3	GCAGTAAGGTcgaggctgagtgtag
sgNT-4	ATCCTGCGGGcgaggctgagtgtag
sgNT-5	CGTGATTGTTcgaggctgagtgtag
sgNT-6	ACGGCACGGAcgaggctgagtgtag
sgNT-8	GAATGGTCATcgaggctgagtgtag
sgNT-9	GGAATCTACAcgaggctgagtgtag
sgNT-10	CCTACTGACCcgaggctgagtgtag
sgNT-11	TTACCGGCCCcgaggctgagtgtag
sgNT-12	GGCTAGAAGTcgaggctgagtgtag
sgNT-13	CCCGCCAGATcgaggctgagtgtag
sgNT-14	TGTCACATGGcgaggctgagtgtag
sgNT-15	GTGAACTCGAcgaggctgagtgtag
sgRPL9-1	TACCACCGTTcgaggctgagtgtag
sgRPL9-2	GCTAAGTTACcgaggctgagtgtag
sgRPL9-3	CTGAGACGTGcgaggctgagtgtag
sgPOLR1D-1	TCTTGCCTAAcgaggctgagtgtag
sgPOLR1D-2	ATTTAACTTGcgaggctgagtgtag
sgPOLR1D-3	CGCTTTAACAcgaggctgagtgtag
sgCAD-1	ACCGTAGACCcgaggctgagtgtag
sgCAD-2	CATATTTGCGcgaggctgagtgtag
sgCAD-3	GAATCCAGGAcgaggctgagtgtag
sgHSPA5-1	AGTGTTCCTGcgaggctgagtgtag
sgHSPA5-2	AAACGCGCAGcgaggctgagtgtag
sgHSPA5-3	TGCGATAGGGcgaggctgagtgtag
