sgGATA1-1	ATGCTCGTTGcgaggctgagtgtag
sgGATA1-2	CGCAGTGAGTcgaggctgagtgtag
sgGATA1-3	CATGCACAGAcgaggctgagtgtag
sgGATA2-1	CATGTAAGACcgaggctgagtgtag
sgGATA2-2	GTTGTGCCAGcgaggctgagtgtag
sgGATA2-3	GGAATGTCGTcgaggctgagtgtag
sgMYC-1	TGTACGCATCcgaggctgagtgtag
sgMYC-2	CGAGTAACTGcgaggctgagtgtag
sgMYC-3	ATGATCGCGAcgaggctgagtgtag
sgRUNX1-1	CAGGACCTGAcgaggctgagtgtag
sgRUNX1-2	CTTACATTGCcgaggctgagtgtag
sgRUNX1-3	TAAGCTGACTcgaggctgagtgtag
sgRUNX2-1	TGTTGACGACcgaggctgagtgtag
sgRUNX2-2	TGGGCGTACTcgaggctgagtgtag
sgRUNX2-3	TAGAGAAACCcgaggctgagtgtag
sgKLF1-1	CTAGAGACTCcgaggctgagtgtag
sgKLF1-2	CAGCCGATGCcgaggctgagtgtag
sgKLF1-3	CGACAATACGcgaggctgagtgtag
sgNT-1	GGCACTTCTAcgaggctgagtgtag
sgNT-2	ATACTGATTCcgaggctgagtgtag
sgNT-3	GCAGTAAGGTcgaggctgagtgtag
